Main Interface   ==    Main Interface
Music   ==    Music
Video   ==    Video
FLASH  Play   ==    FLASH  Play
Picture   ==    Picture
Radio   ==    Radio
Record   ==    Record
E-Book   ==    E-Book
Playing   ==    Playing
Browser   ==    Browser
Games   ==    Games
System Set   ==    System Set
Blight Time   ==    Blight Time
About   ==    About
Important Notice   ==    Important Notice
Main Menu   ==    Main Menu
Display   ==    Display
Button Sound   ==    Button Sound
Date & Time   ==    Date & Time
Language   ==    Language
Auto Off   ==    Auto Off
Auto Off   ==    Auto Off
USB Mode   ==    USB Mode
Default Set   ==    Default Set
Blight Time   ==    Blight Time
Background Lights   ==    Background Lights
Background Transparency   ==    Background Transparency
Fonts Colour   ==    Fonts Colour
Choice Strip Color   ==    Choice Strip Color
Back To Default Background   ==    Back To Default Background
5 secs   ==    5 secs
10 secs   ==    10 secs
15 secs   ==    15 secs
20 secs   ==    20 secs
30 secs   ==    30 secs
Always On   ==    Always On
Off   ==    Off
On   ==    On
>   ==    >
OK   ==    OK
Cancel   ==    Cancel
White   ==    White
Gray   ==    Gray
Dark White   ==    Dark White
Blue   ==    Blue
Green   ==    Green
Violet   ==    Violet
Orange   ==    Orange
Pink   ==    Pink
Delete   ==    Delete
Play   ==    Play
Add to current playlist   ==    Add to current playlist
Add to my playlist   ==    Add to my playlist
Connect to USB   ==    Connect to USB
Play Rec   ==    Play Rec
Start Rec   ==    Start Rec
Recording current Radio station   ==    Recording current Radio station
Listen Radio   ==    Listen Radio
FM List   ==    FM List
Updata FM Playlist   ==    Updata FM Playlist
Choose FM Playlist   ==    Choose FM Playlist
Stereo Switch   ==    Stereo Switch
File Name   ==    File Name
Title   ==    Title
Artist   ==    Artist
Album   ==    Album
Turn off order   ==    Turn off order
Sampling Rate   ==    Sampling Rate
Bit Rate   ==    Bit Rate
Unknown   ==    Unknown
3D Games   ==    3D Games
GBA Games   ==    GBA Games
GBA Sound Settings   ==    GBA Sound Settings
GBA Display Setting   ==    GBA Display Setting
Original Size   ==    Original Size
Zoom with scale   ==    Zoom with scale
Full Screen Display   ==    Full Screen Display
Signal Power Adjust   ==    Signal Power Adjust
Low   ==    Low
Mid   ==    Mid
High   ==    High
Internal   ==    Internal
External   ==    External
All Songs   ==    All Songs
Playlist   ==    Playlist
Album   ==    Album
Play Orders   ==    Play Orders
Update Jukebox   ==    Update Jukebox
Play Mode   ==    Play Mode
EQ Select   ==    EQ Select
All Repeat   ==    All Repeat
Order   ==    Order
Shuffle   ==    Shuffle
Repeat Once   ==    Repeat Once
Once   ==    Once
Rencent Videos   ==    Rencent Videos
Video Settings   ==    Video Settings
Listen Radio   ==    Listen Radio
Save This Station   ==    Save This Station
Background Play   ==    Background Play
Close   ==    Close
Normal   ==    Normal
Jazz   ==    Jazz
Pop   ==    Pop
Rock   ==    Rock
Classic   ==    Classic
Vocal   ==    Vocal
Treble   ==    Treble
Bass   ==    Bass
Video Times   ==    Video Times
Display current time   ==    Display current time
Display full times   ==    Display full times
Show all time   ==    Show all time
Turn off display time   ==    Turn off display time
10 min   ==    10 min
30 min   ==    30 min
1 hr.   ==    1 hr.
Switch Off   ==    Switch Off
No File Found!   ==    No File Found!
Video Playlist   ==    Video Playlist
USB Connecting   ==    USB Connecting
USB Connected...   ==    USB Connected...
UDisk Memory   ==    UDisk Memory
UDisk Free   ==    UDisk Free
Model   SDK   ==    Model   SDK
Version V1.03   ==    Version V1.03
(c) 2007-2008 CHINACHIP   ==    (c) 2007-2008 CHINACHIP
File List   ==    File List
Music Playlist   ==    Music Playlist
U Disk   ==    U Disk
MINISD Card   ==    MINISD Card
Browse All Files   ==    Browse All Files
Theme Choose   ==    Theme Choose
Theme One   ==    Theme One
Theme Two   ==    Theme Two
Theme Three   ==    Theme Three
Theme Four   ==    Theme Four
No FM station info!   ==    No FM station info!
Flash Playlist   ==    Flash Playlist
MINISD card out!   ==    MINISD card out!
Unkown music format!   ==    Unkown music format!
File doesn't exist!   ==    File doesn't exist!
Unknown Tite   ==    Unknown Tite
Unkown Artist   ==    Unkown Artist
Unkown Album   ==    Unkown Album
White   ==    White
Red   ==    Red
DarkRed   ==    DarkRed
Green   ==    Green
Dark Green   ==    Dark Green
Blue   ==    Blue
Dark Blue   ==    Dark Blue
Dark White   ==    Dark White
Green Blue   ==    Green Blue
Violet   ==    Violet
Dark Violet   ==    Dark Violet
Yellow   ==    Yellow
Dark Yellow   ==    Dark Yellow
Gray   ==    Gray
Black   ==    Black
GBA Game Playlist   ==    GBA Game Playlist
Not enough space!   ==    Not enough space!
No File Found!   ==    No File Found!
Snakes   ==    Snakes
No File Found!   ==    No File Found!
Folder Once   ==    Folder Once
MINISD card out!   ==    MINISD card out!
Speaker   ==    Speaker
No HeadPhone,No Fm Update!   ==    No HeadPhone,No Fm Update!
No HeadPhone,No listen!   ==    No HeadPhone,No listen!
Please plug the USB calbe!   ==    Please plug the USB calbe!
Press \"MENU\" to quit!   ==    Press \"MENU\" to quit!
Press \"Left\" to quit!   ==    Press \"Left\" to quit!
No File Found!   ==    No File Found!
Not Enough Space!   ==    Not Enough Space!
Picture module error!   ==    Picture module error!
Music Background Pic   ==    Music Background Pic
FM radio background pic   ==    FM radio background pic
Recording Background Pic   ==    Recording Background Pic
E-Book Background Pic   ==    E-Book Background Pic
Main Menu Background Pic   ==    Main Menu Background Pic
Slide Show Switch Times   ==    Slide Show Switch Times
Open slide show   ==    Open slide show
Close slide show   ==    Close slide show
2 secs   ==    2 secs
3 secs   ==    3 secs
5 secs   ==    5 secs
8 secs   ==    8 secs
15 secs   ==    15 secs
Unknow media format!   ==    Unknow media format!
Read media format error!   ==    Read media format error!
Continue Play   ==    Continue Play
China   ==    China
Europe   ==    Europe
U.S.A   ==    U.S.A
Japan   ==    Japan
FM  Region   ==    FM  Region
MINISD Memory   ==    MINISD Memory
MINISD Free   ==    MINISD Free
Erros   ==    Erros
File doesn't exist,can't open!   ==    File doesn't exist,can't open!
No enough memory,can't open!   ==    No enough memory,can't open!
Empty file,can't Read!   ==    Empty file,can't Read!
File too big, can't open!   ==    File too big, can't open!
No File Found!   ==    No File Found!
Not Enough Memory!   ==    Not Enough Memory!
Can't use bookmark!   ==    Can't use bookmark!
Set  1st bookmark   ==    Set  1st bookmark
Set  2nd bookmark   ==    Set  2nd bookmark
Set  3rd bookmark   ==    Set  3rd bookmark
Set  4th bookmark   ==    Set  4th bookmark
Jump to 1st bookmark   ==    Jump to 1st bookmark
Jump to 2nd bookmark   ==    Jump to 2nd bookmark
Jump to 3rd bookmark   ==    Jump to 3rd bookmark
Jump to 4th bookmark   ==    Jump to 4th bookmark
TTS engine loading...   ==    TTS engine loading...
25 secs   ==    25 secs
35 secs   ==    35 secs
Auto Next Page   ==    Auto Next Page
Bookmark   ==    Bookmark
Auto Play Set   ==    Auto Play Set
TTS read   ==    TTS read
No Bookmark!   ==    No Bookmark!
End!   ==    End!
Top!   ==    Top!
Run from last   ==    Run from last
Yes   ==    Yes
No   ==    No
Finish Record and Saved!   ==    Finish Record and Saved!
Press any button to quit   ==    Press any button to quit
Not Enough Space!   ==    Not Enough Space!
Recording time remaining:   ==    Recording time remaining:
FM Stations   ==    FM Stations
Hardware Error!   ==    Hardware Error!
Please check FM module line!   ==    Please check FM module line!
Update FM playlist first!   ==    Update FM playlist first!
Manual adjust Radio frequency   ==    Manual adjust Radio frequency
FM Station Serching .....   ==    FM Station Serching .....
Recording...   ==    Recording...
Continue from last time?   ==    Continue from last time?
Disk Is Full,Can't use bookmark   ==    Disk Is Full,Can't use bookmark
Animation Picture   ==    Animation Picture
1 min   ==    1 min
3 min   ==    3 min
10 min    ==    10 min 
Close   ==    Close
Candy House   ==    Candy House
Brick   ==    Brick
E-Book fonts   ==    E-Book fonts
Big Font   ==    Big Font
Small Font   ==    Small Font
Customize   ==    Customize
File saving...   ==    File saving...
Initializing...   ==    Initializing...
Rec Quality   ==    Rec Quality
Low   ==    Low
Middle   ==    Middle
High   ==    High
100 ms   ==    100 ms
200 ms   ==    200 ms
300 ms   ==    300 ms
400 ms   ==    400 ms
500 ms   ==    500 ms
Deleting File   ==    Deleting File
Deleting file!   ==    Deleting file!
Please open FM!   ==    Please open FM!
FM Record   ==    FM Record
Normal   ==    Normal
FillBox   ==    FillBox
FullScreen   ==    FullScreen
Zoom Mode   ==    Zoom Mode
Low Battery!   ==    Low Battery!
No music is playing!   ==    No music is playing!
Right direction   ==    Right direction
Left direction   ==    Left direction
Screen direction   ==    Screen direction
Automatically search radio   ==    Automatically search radio
Main menu style   ==    Main menu style
List   ==    List
Icon   ==    Icon
TV standard    ==    TV standard 
TV screens set up    ==    TV screens set up 
TV screen    ==    TV screen 
TV    ==    TV 
P system    ==    P system 
N system    ==    N system 
16:9    ==    16:9 
4:3    ==    4:3 
TV    ==    TV 
Screen   ==    Screen
Broswer   ==    Broswer
Main choice   ==    Main choice
Animated icon   ==    Animated icon
General icon   ==    General icon
List   ==    List
TV types   ==    TV types
LCD   ==    LCD
General   ==    General
Off   ==    Off
Concert Hall   ==    Concert Hall
Small room   ==    Small room
Large room   ==    Large room
Scene   ==    Scene
Stadium   ==    Stadium
Virtual sound field   ==    Virtual sound field
Campus Channel   ==    Campus Channel
Udisk immunity   ==    Udisk immunity
Theme five   ==    Theme five
EQ    ==    EQ 
TV setup   ==    TV setup
Music setup   ==    Music setup
Video setup   ==    Video setup
Radio setup   ==    Radio setup
Record setup   ==    Record setup
System setup   ==    System setup
Open/close TV   ==    Open/close TV
Connect TV   ==    Connect TV
cClose TV   ==    cClose TV
GAME LIST   ==    GAME LIST
Game center   ==    Game center
Music hall    ==    Music hall 
Movie theater   ==    Movie theater
Picture room   ==    Picture room
Library   ==    Library
Record   ==    Record
Albums   ==    Albums
Artist   ==    Artist
Songs   ==    Songs
Search music   ==    Search music
3D game   ==    3D game
Interesting game   ==    Interesting game
Press right key to search music    ==    Press right key to search music 
Search result   ==    Search result
Sound output setting   ==    Sound output setting
3D processing    ==    3D processing 
Automatic volume balance    ==    Automatic volume balance 
Bass   ==    Bass
High-frequency compensation    ==    High-frequency compensation 
3D audio settings    ==    3D audio settings 
General headphones    ==    General headphones 
Hi-fi headphones    ==    Hi-fi headphones 
General Speaker    ==    General Speaker 
Larger speakers    ==    Larger speakers 
Close   ==    Close
Weak    ==    Weak 
Medium   ==    Medium
Strong   ==    Strong
Simulator not exit,download please!   ==    Simulator not exit,download please!
Copy   ==    Copy
Paste   ==    Paste
Suspended recording   ==    Suspended recording
Need No Bookmark   ==    Need No Bookmark
Background Set   ==    Background Set
Jump Read   ==    Jump Read
Jump Backward 20 Pages   ==    Jump Backward 20 Pages
Jump To Page100   ==    Jump To Page100
Jump To Page250   ==    Jump To Page250
Jump To Page500   ==    Jump To Page500
Jump To Page1000   ==    Jump To Page1000
Continue Playing?   ==    Continue Playing?
Stop recording   ==    Stop recording
File exists,replace it?   ==    File exists,replace it?
Add to favorites   ==    Add to favorites
Can not set fontsize   ==    Can not set fontsize
Can not set fontcolor   ==    Can not set fontcolor
Text To Sound   ==    Text To Sound
Model:   ==    Model:
A320   ==    A320
File name is too long!   ==    File name is too long!
Favorites   ==    Favorites
Pedometer   ==    Pedometer
Start   ==    Start
Stride Setting   ==    Stride Setting
Record List   ==    Record List
To delete the record    ==    To delete the record 
To delete all records    ==    To delete all records 
Was deleted   ==    Was deleted
Walk state	   ==    Walk state	
State quickly    ==    State quickly 
Normal state   ==    Normal state
Records list   ==    Records list
Update Finished   ==    Update Finished
Total   ==    Total
Select   ==    Select
Do not put out sd card   ==    Do not put out sd card
   ==    
   ==    
   ==    
   ==    
